14
15
0 9 0 10 0 3 0 0 0 0 0 0 8 0 3
1 1 1 1 1 1 1 6 6 6 6 1 1 1 1
0 0 0 0 0 0 0 0 0 0 0 0 0 0 0
0 0 0 0 0 0 0 0 0 3 0 0 0 0 0
0 0 3 0 0 0 0 1 1 1 0 0 0 0 0
0 0 1 0 0 0 5 1 0 0 0 0 0 0 0
0 1 0 0 0 0 1 1 0 0 0 0 0 0 0
0 0 0 0 0 0 0 0 0 0 0 0 0 0 0
0 7 0 0 3 0 0 0 3 0 0 0 0 0 0
0 0 0 0 1 0 0 0 1 0 0 0 0 0 0
0 0 0 0 0 0 0 0 0 0 0 0 0 0 0
0 0 0 0 0 0 0 0 0 0 0 0 0 0 0
3 0 0 0 3 0 0 0 3 0 0 0 3 0 0
1 0 0 0 1 0 0 0 1 0 0 0 1 0 0