14
15
1 1 1 2 1 6 1 6 6 1 0 0 0 0 0
0 0 0 7 0 0 0 0 0 0 1 0 0 9 5
0 0 0 0 0 0 0 0 0 0 0 1 1 1 1
0 0 5 7 0 4 0 3 0 0 0 0 0 0 0
0 0 1 1 1 1 1 1 0 0 0 0 0 0 0
0 0 0 0 0 0 0 0 0 0 0 0 0 0 0
0 0 3 0 0 5 0 4 0 0 0 0 0 0 0
0 0 1 6 1 1 1 1 1 0 0 5 0 0 0
0 0 0 0 0 0 0 0 0 0 0 1 1 0 0
0 0 0 0 0 0 0 0 0 0 0 1 0 0 0
0 0 0 0 5 0 0 1 1 0 0 1 0 0 0
0 0 0 0 0 1 1 0 0 0 0 0 0 0 0
0 0 0 0 0 0 0 0 1 1 0 0 8 0 0
0 0 0 0 0 0 0 0 0 0 0 0 1 1 0