14
15
0 0 0 0 0 0 0 0 0 0 0 0 0 0 0
0 0 0 0 0 0 0 0 0 0 0 0 0 0 0
0 0 0 0 0 0 0 0 0 0 0 0 0 0 0
0 0 0 0 0 0 0 0 0 0 0 0 0 0 0
0 0 0 0 0 0 0 0 0 0 0 0 0 0 0
10 0 8 0 0 0 1 2 0 0 5 5 0 3 0
1 1 1 1 6 6 6 6 6 1 1 1 1 1 1
1 0 0 0 2 0 0 0 0 0 0 1 0 0 1
1 3 0 4 0 4 0 4 0 0 3 1 0 9 1
1 1 1 2 2 1 1 1 1 1 1 1 1 1 1
1 0 2 0 1 0 0 1 1 0 0 0 0 0 1
1 0 2 0 2 0 0 0 2 0 0 0 7 0 1
1 3 2 0 2 0 0 0 0 0 0 0 1 0 1
1 1 1 0 1 1 2 2 1 6 6 1 1 1 1