14
15
8 0 0 0 0 0 0 0 0 0 0 0 0 0 0
1 1 0 0 0 0 4 0 0 0 0 5 0 0 0
0 0 0 0 1 1 1 0 0 0 0 0 0 0 0
0 0 0 0 0 0 0 0 0 0 0 0 4 0 0
0 0 0 0 0 0 0 0 1 0 0 0 1 1 1
0 4 0 3 0 0 1 0 0 0 0 0 0 0 0
0 1 1 1 0 1 0 0 0 0 0 0 0 4 9
0 0 0 0 0 0 0 0 5 0 0 0 0 2 1
0 0 7 4 0 0 0 0 0 0 4 0 0 0 0
0 0 1 2 2 2 0 5 2 2 2 0 5 0 0
0 0 0 0 0 0 0 1 0 0 0 0 0 0 0
0 5 0 0 0 0 0 0 0 0 0 0 0 0 0
0 0 0 0 0 0 0 0 0 0 0 0 0 0 0
6 6 6 6 6 6 6 6 6 6 6 6 6 6 6