10
30
0 0 0 0 0 1 0 0 0 0 0 0 1 1 1 1 1 1 1 1 1 1 1 1 1 1 1 1 1 1
0 0 0 0 1 0 0 0 0 0 0 0 1 0 0 0 0 0 0 0 0 5 0 0 0 0 0 0 0 0
3 0 0 2 0 7 0 0 0 0 3 0 1 3 0 0 0 0 0 0 0 1 0 0 0 0 0 0 0 0
1 2 2 0 0 1 0 0 1 1 1 0 1 1 2 2 1 1 1 1 1 2 1 1 1 2 1 1 1 1
0 0 0 0 0 0 0 0 0 0 0 0 1 0 0 0 0 1 2 2 2 2 2 2 2 1 1 0 0 0
0 0 0 0 0 0 0 0 0 0 0 0 1 0 0 0 0 1 2 2 2 2 2 2 2 2 1 0 0 0
0 0 0 0 0 0 0 0 0 0 3 0 1 0 0 0 0 2 2 11 2 2 11 2 11 2 1 0 0 0
0 0 0 0 0 0 1 2 2 1 1 0 1 0 0 0 0 2 2 2 2 2 2 2 2 2 1 0 0 0
0 8 0 0 1 0 0 0 0 0 0 0 1 0 0 0 0 1 1 2 11 2 2 9 2 2 1 0 0 0
1 1 1 0 0 0 0 0 0 0 0 0 1 6 6 6 6 1 1 1 1 1 1 1 1 1 1 0 0 0