14
15
1 0 0 0 0 0 0 0 0 0 0 0 0 0 0
1 0 0 0 0 0 0 0 0 0 0 0 0 0 0
1 0 0 0 0 0 0 0 0 0 0 0 0 0 1
1 9 0 5 1 0 0 0 0 0 0 1 1 1 0
1 1 1 1 1 1 1 2 2 1 1 0 0 0 7
1 0 0 0 0 0 0 0 0 0 0 0 1 2 1
1 1 0 0 4 0 0 4 0 0 0 1 0 0 0
1 0 0 1 1 0 2 1 6 6 1 0 0 0 0
1 7 0 0 0 0 0 0 0 0 0 0 0 0 0
1 1 0 0 0 0 0 0 0 0 0 0 0 0 0
1 0 1 1 0 0 4 0 0 0 0 0 0 0 0
1 0 0 0 0 0 1 1 0 0 0 0 0 0 0
1 0 0 0 0 0 0 0 0 0 1 1 0 8 0
1 1 1 1 1 1 1 1 1 1 1 1 1 1 1