14
15
1 0 0 0 0 0 0 0 0 0 0 0 0 0 0
0 1 0 4 0 0 0 0 0 0 0 0 0 0 3
7 0 2 1 2 2 1 0 0 1 0 2 1 0 1
1 0 0 0 0 2 0 1 2 0 0 0 0 0 0
0 0 2 0 0 0 0 0 0 0 0 0 0 0 0
7 0 0 0 0 0 0 0 0 0 4 1 1 1 0
1 0 0 0 0 0 0 8 0 0 1 3 0 4 0
0 1 0 0 1 1 1 1 1 1 1 1 1 1 1
4 0 0 2 1 3 0 0 0 0 0 3 1 0 0
1 2 2 2 0 1 0 9 0 0 0 0 1 0 0
1 0 0 0 1 4 1 1 1 1 4 1 1 4 0
1 0 0 0 4 1 0 0 0 0 1 0 0 1 1
1 6 6 6 1 0 0 0 4 0 0 0 0 1 0
1 1 1 1 0 0 0 1 1 0 0 0 0 1 1