15
25
0 0 0 0 0 0 0 0 0 0 0 0 0 0 0 0 0 0 0 0 0 0 0 0 9
0 0 0 0 0 0 0 0 0 0 0 0 0 0 1 11 1 2 1 1 1 0 1 0 1
0 0 0 0 1 1 0 0 0 0 0 0 0 0 0 0 0 2 0 0 0 0 1 0 0
1 1 3 1 0 0 0 0 0 0 0 0 0 1 7 0 0 2 0 0 0 1 0 0 0
0 0 1 0 0 0 0 0 0 0 0 0 1 0 6 6 6 1 0 0 1 0 0 0 0
0 0 0 0 0 0 0 0 5 0 1 0 0 0 1 1 1 1 1 1 4 0 0 0 0
0 0 0 0 6 0 5 0 0 0 0 1 0 0 1 0 0 1 0 0 1 0 0 0 0
0 0 0 0 0 0 0 2 0 0 0 0 0 0 1 5 3 1 3 0 0 1 0 0 0
0 0 5 0 1 0 0 0 11 11 1 1 1 0 1 1 1 1 1 0 0 1 0 0 1
0 0 0 0 0 0 1 0 0 0 0 0 0 6 0 0 0 1 0 0 1 0 1 0 0
0 0 5 0 0 0 0 0 0 0 0 0 7 6 0 4 0 1 1 0 0 0 1 3 1
0 0 0 0 5 0 0 0 0 2 2 1 1 0 0 1 1 1 0 0 1 0 0 1 0
0 0 3 0 0 0 0 1 1 0 0 0 0 0 0 0 0 1 1 0 0 0 0 0 0
0 0 1 0 0 0 0 0 0 0 0 1 1 0 0 1 0 0 4 0 0 8 0 0 3
1 1 1 11 1 2 2 1 1 1 1 1 1 1 1 1 1 1 1 1 1 1 1 1 1